サーバー	サーバ
フィルター	フィルタ
ハンドラー	ハンドラ
ユーザー	ユーザ
分かる	わかる
全て	すべて
毎	ごと
例えば	たとえば
無い	ない
無し	なし
有り	あり
有る	ある
ダブルコート	ダブルクォート
ダブルコーテーション	ダブルクォーテーション
その為	そのため
通り	とおり
戻り値	返り値
奨める	勧める
下さい	ください
色々	いろいろ
最も	もっとも
構いません	かまいません
チェイン	チェーン
良い	よい
切り替え	切替
持つ	もつ
し易さ	しやすさ
わける	分ける
呼出	呼び出し
アクセッサ	アクセサ
おこなう	行う
インタフェース	インターフェース
インターフェイス	インターフェース
もとに	元に
解説	説明
How To Use	How to use
How To Extends	How to extends
Bean定義ファイル	Bean定義
1つのジョブ	1ジョブ
